########
#A     #
### ## #
#     G#
########