###################
#               A #
#####             #
#G    #           #
###################
