###################
#               A #
#                 #
#G                #
###################
